#AddDeviceController

DeviceDescription=Enhetsbeskrivning
Optional=Frivillig

Device=Enhet
Light=Ljus
Sensor=Sensor
WashingMachine=Tvättmaskin
Dishwasher=Diskmaskin
VacuumCleaner=Dammsugare
Sauna=Bastu
Lock=Låsa
Camera=Kamera
Temperature=Temperatur
Humidity=Fuktighet
CO2=CO2
Motion=Rörelse
Cotton=Bomull
FineWash=Fintvätt
Sport=Sport
Eco=Eco
Fast=Snabb
PowerWash=Högtryckstvätt

AddDeviceName=Lägg till enhetsnamn
SelectDeviceType=Välj enhetstyp
SelectDeviceSubtype=Välj Enhetsundertyp
SelectSensorType=Välj sensortyp

AddingDeviceSuccessfull=Enheten har lagts till
DeviceAddedSuccessfully=Enhet har lagts till
PowerOn=Ström på
PowerOff=Stäng av
CO2Concentration=CO2-koncentration
Cold=Kall
Neutral=Neutral
Warm=Varm
Brightness=Ljusstyrka
Function=Funktion

Monday=måndag
Tuesday=tisdag
Wednesday=onsdag
Thursday=torsdag
Friday=fredag
Saturday=lördag
Sunday=söndag

Vacuuming=Dammsugning
Mopping=Moppning
Locking=Låsning
Recording=Upptagning


#DataDisplayController

UnexpectedValue=Oväntat värde


#ForgotPasswordController

EnterUsername=Skriv in ditt användarnamn
UserNotFound=Användaren hittades inte
EnterTheAnswersToTheQuestions=Skriv in svaren på frågorna
TheAnswersDoNotMatch=Svaren stämmer inte överens
EnterPassword=Skriv in lösenord
PasswordChanged=Lösenordet ändrat
PasswordChangedSuccessfully=Lösenordet har ändrats


#LoginController

EnterUsernameInCorrectFormat=Ange användarnamn i rätt format
IncorrectUsernameOrPassword=Felaktigt användarnamn eller lösenord


#ProfileController

UsernameReserved=Användarnamn reserverat
UsernameChanged=Användarnamn ändrat
UsernameChangedSuccessfully=Användarnamnet har ändrats
EnterQuestionAnswer=Ange Fråga Svar
InvalidQuestionAnswer=Ogiltigt fråga svar
UserCreated=Användare skapad
UserCreatedSuccessfully=Användaren har skapats framgångsrikt


#addDevice

AddNewDevice=Lägg till ny enhet
DeviceName=Enhetsnamn
Name=Namn
Type=Typ
DeviceType=Enhetstyp
Description=Beskrivning
SensorType=Sensortyp
LightBrightness=Ljus Ljusstyrka
ColorTemperature=Färgtemperatur
LightStatus=Ljusstatus
MotionSensor=Rörelsesensor
StartNow=Börja nu
Timer=Timer
FastWash=Snabb tvätt
WashProgram=Tvättprogram
Spinning=Spinning
ExtraRinse=Extra sköljning
Program=Program
CleaningDays=Städdagar
ActiveTime=Aktiv tid
Command=Befallning
HeatingTime=Uppvärmningstid
Locked=Låst
CameraOn=Kamera på
AddDeviceToFavorites=Lägg till enhet till favoriter
AddDevice=Lägg till enhet


#allDevicesView

Favorite=Favorit
AllDevices=Alla enheter


#deviceDataView

ChooseDevice=Välj Enhet
Messages=Meddelanden
DeviceData=Enhetsdata


#favoriteDevicesView

FavoriteDevice=Favoritenhet


#forgotPasswordView

Answer=Svar
Back=Tillbaka
Submit=Överlämna
Question1=Fråga 1
Question2=Fråga 2
Question3=Fråga 3
PasswordResetQuestions=Frågor om lösenordsåterställning
NewPassword=Nytt lösenord
ChangePassword=Ändra lösenord


#login

SignIn=Logga in
CreateUser=Skapa användare
ForgotPassword=Glömt ditt lösenord


#mainView

FavoriteDevices=Favoritenheter
AllDevices=Alla enheter
Profile=Profil
Logout=Logga ut


#profileView

MyProfile=Min profil
EditProfile=Redigera profil
Save=Spara


#registerView

Register=Registrera
PasswordRecoveryQuestions=Frågor om lösenordsåterställning
CreateUser=Skapa användare